4444444444444444444444444
4000000000000000000000004
4000011110000000111100004
4000222222000002222220004
4003333333300033333333004
4022222222220222222222204
4011111111111111111111104
4001111111111111111111004
4000111111111111111110004
4000011111111111111100004
4000001111111111111000004
4000000111111111110000004
4000000011111111100000004
4000000001111111000000004
4000000000111110000000004
4000000000011100000000004
4001100000001000000000004
4011110000000000000000004
4013310000000030000100004
4001122222222213001000004
4001122222222213010000004
4013310000000030001000004
4011110000000000000100004
4001100000000000000000004
4000000000000000000000004
4000000000000000000000004
4000000000000000000000004
4000000000000000000000004
4000000000000000000000004
4000000000000000000000004
4000000000000000000000004
4000000000000000000000004

