5555555555555555555555555
5000000000000000000000005
5000011110000000111100005
5000222222000002222220005
5003333333300033333333005
5022222222220222222222205
5011111111111111111111105
5001111111111111111111005
5000111111111111111110005
5000011111111111111100005
5000001111111111111000005
5000000111111111110000005
5000000011111111100000005
5000000001111111000000005
5000000000111110000000005
5000000000011100000000005
5001100000001000000000005
5011110000000444440000005
5013310044444030000100005
5001122222222213001000005
5001122222222213010000005
5013310000000030001000005
5011110000000000000100005
5001100000000000000000005
5000000000000000000000005
5000000000000000000000005
5000000000000000000000005
5000000000000000000000005
5000000000000000000000005
5000000000000000000000005
5000000000000000000000005
5000000000000000000000005

