1111111111111111111111111
1000000000000000000000001
1000022220000000222200001
1000333333000003333330001
1004444444400044444444001
1033333333330333333333301
1022222222222222222222201
1002222222222222222222001
1000222222222222222220001
1000022222222222222200001
1000002222222222222000001
1000000222222222220000001
1000000022222222200000001
1000000002222222000000001
1000000000222220000000001
1000000000022200000000001
1000000000002000000000001
1000000000000000000000001
1000000000000000000000001
1000000000000000000000001
1000000000000000000000001
1000000000000000000000001
1000000000000000000000001
1000000000000000000000001
1000000000000000000000001
1000000000000000000000001
1000000000000000000000001
1000000000000000000000001
1000000000000000000000001
1000000000000000000000001
1000000000000000000000001
1000000000000000000000001

