5555555555555555555555555
5000000000000000000000005
5310000000000000000000005
5431000000000000000000005
5043100000000000000000005
5004310000000000000000005
5000431000000000000000005
5000043100000002000000005
5000004310000002000000005
5000000431000002000000005
5000000043100002000000005
5000000004310002000000005
5000000000431002000000005
5000000000043102000000005
5000000000004312000000005
5000000000000431000000005
5000000000000044400000005
5000000000000000000000005
5000111111111111111110005
5000111111111111111110005
5000222222222222222220005
5000333333333333333330005
5000444444444444444440005
5000111111111111111110005
5000000000000000000000005
5000000000000000000000005
5000000000000000000000005
5000000000000000000000005
5000000000000000000000005
